13
13
182 151 151 151 151 151 151 151 151 151 151 151 183
150 74  59  18  59  59  11  59  58  59  164 75  150
150 59  98  98  96  98  99  99  99  99  99  59  150
150 154 98  114 114 98  98  99  115 115 115 59  150
150 59  98  26  27  114 98  98  26  27  131 59  150
150 59  98  42  43  99  99  99  42  43  131 2   150
150 58  98  114 98  98  99  115 115 130 131 59  150
150 59  98  130 114 114 115 131 131 130 131 59  150
150 59  98  26  27  130 131 98  26  27  131 59  150
150 59  114 42  43  114 114 114 42  43  131 59  150
150 56  130 130 130 130 130 154 130 130 131 59  150
150 11  56  59  59  59  59  58  59  59  2   18  150
182 151 151 151 151 151 151 151 151 151 151 151 183